#####................
#...#................
#...#................
#...#................
#...#................
#..@#................
#...#................
#...#................
#...#................
#...#................
#...#................
#...#................
#...#................
#...#................
#...#................
#####...............
....................